2 13 31
###############################
#p * *2    4  *  ** * * 2    *#
# # # # #*# # #*# # # # # #*# #
#    * * *** **  6   *    **  #
# #*# # # # #1# #b#1# # # # #*#
#     3    *     ** 3    *  **#
# # #*# # # # # #*#*#*#*# # # #
#   *  3     *3  * *x* *      #
# #f# # #*# # # # # # #*# #*# #
#   ****   1     *1        4  #
# # # # # # # # # #*# # # # #*#
#  ** * 6 *    2              #
###############################